//MAP CONVERTED BY dmm2tgm.py THIS HEADER COMMENT PREVENTS RECONVERSION, DO NOT REMOVE
"a" = (
/obj/structure/safe/floor{
	name = "prohibition-era floor safe"
	},
/obj/effect/spawner/random/contraband/narcotics,
/obj/item/gun/ballistic/automatic/tommygun,
/obj/effect/spawner/random/food_or_drink/booze,
/obj/effect/spawner/random/food_or_drink/booze,
/obj/effect/spawner/random/food_or_drink/booze,
/obj/effect/spawner/random/entertainment/money_large,
/obj/modular_map_connector,
/obj/structure/table/wood,
/turf/template_noop,
/area/template_noop)

(1,1,1) = {"
a
"}
