//MAP CONVERTED BY dmm2tgm.py THIS HEADER COMMENT PREVENTS RECONVERSION, DO NOT REMOVE
"a" = (
/obj/modular_map_connector,
/obj/effect/mob_spawn/corpse/human/syndicatepilot,
/obj/effect/turf_decal/sand,
/obj/item/compact_remote,
/mob/living/simple_animal/hostile/bee/toxin,
/turf/template_noop,
/area/template_noop)

(1,1,1) = {"
a
"}
