//MAP CONVERTED BY dmm2tgm.py THIS HEADER COMMENT PREVENTS RECONVERSION, DO NOT REMOVE
"a" = (
/obj/modular_map_connector,
/obj/structure/sign/painting/library_private{
	pixel_x = 32
	},
/obj/structure/chair/comfy/beige{
	dir = 4
	},
/obj/item/stack/medical/bone_gel,
/turf/template_noop,
/area/template_noop)

(1,1,1) = {"
a
"}
