//MAP CONVERTED BY dmm2tgm.py THIS HEADER COMMENT PREVENTS RECONVERSION, DO NOT REMOVE
"a" = (
/obj/structure/statue/petrified,
/obj/modular_map_connector,
/turf/template_noop,
/area/template_noop)

(1,1,1) = {"
a
"}
