//MAP CONVERTED BY dmm2tgm.py THIS HEADER COMMENT PREVENTS RECONVERSION, DO NOT REMOVE
"a" = (
/obj/modular_map_connector,
/obj/structure/bonfire,
/obj/item/reagent_containers/cup/glass/bottle/juice/orangejuice,
/turf/template_noop,
/area/template_noop)

(1,1,1) = {"
a
"}
